שעושה אותו גלל - מרבה לו זבל ושורף את הזרעים שנזרעו בו:
מתני' את הנבלות ואת הקברות כו' - משום ריח רע: אלא למזרח
העיר - שאין הרוח מזרחית קשה תדיר אא"כ באה לפורענות
אבל כדרכה היא חמה ומנשבת בנחת דכתיב רוח קדים
חרישית ותך השמש וגו' לפיכך אינה
מביאה הרוח לעיר: חוץ מן מערבה
- בגמ' מפרש טעמא: שאינו
עושה
כלל - ומרחיק נ' אמה דקאמר ר"ע
אשאר רוחות דרישא קאי: תדירא
ברוחות - אותו צד תדיר ברוח
שרוח מערבית מנשבת תדיר משאר
רוחות: רוח צפונית מנשבת עם כל
אחת - מהרוחות לפי שהיא רכה
ומתוקה וצלולה כדאמר ביבמות
(דף עב.) וממתקתן: בן נץ - מלאך
העשוי בדמות נץ: מעמידה - בכנפיו:
תדירא בשכינה - במערב היא שוכנת:
לאבותינו - אנשי כנה"ג שאמרו מקרא
זה בספר עזרא: וצבא השמים
- השמש והירח העומדים במזרח: לך
משתחוים - למערב: אתה הוא
ה' לבדך - בתר וצבא השמים כתיב ועל עסקי שליחות
צבא השמים הוא משבח
ואומר אתה הוא לבדך במדה זו: לשם מחזירין שליחותן -
כשבאין לומר עשינו שליחותך צריכין לשוב אל
מקום שהשולחם עומד
שם: למקום שמשתלחין -
פי' באותו מקום שנשתלחו שם אף שם השכינה מצויה ואומרים
לו עשינו שליחותך: לכל רוחתא אוקמן - העמידני להתפלל:
דמורו בה מיני - תלמידי עובדי ע"ז מורים הוראה להתפלל
במזרח: יערוף כמטר לקחי
- משה רבינו דימה את התורה
לארבע רוחות כשם שאי אפשר בלא הם
כך אי אפשר לעולם בלא תורה: מערפו של עולם
- אני שמעתי מחזקו של עולם על שם שהשכינה במערב ס"ל ואני
אומר מאחוריו של עולם שהמערב קרוי אחור שנאמר הן
קדם אהלך ואיננו ואחור ולא אבין וגו' : שמזלת את
הזהב - שמחממת ומביאה שרב
ורעבון בא והזהב זל:
