דשגר עובד כוכבים - הסיק בתנור: דג מליח - שמלחו
העובד
כוכבים ובמליחתו הוא נאכל בלא בישול: חזקיה שרי - דלאו הוא
בישול: ביצה צלויה - שצלאה עובד
כוכבים: בר קפרא שרי - הואיל
ובליע אוכל דידיה ולא נגע עובד
כוכבים באוכלא: ור' יוחנן
אסר - דזהו בישולו: אשקיה -
אשקיוהו לרב זביד:
נגוטא דחלא - הנך דבי ריש גלותא
דלא הוו מעלו משום דאחמיר עלייהו: הקפריסין - שומר לפרי הן ממין
צלף ודרך לאכלן חיין ויש ששולקין אותן ואם בישלן עובד
כוכבים מותרין: והקפלוטות
- כרתי נאכלין כמות שהן חיין:
והמטליא - לקמן מפרש: והחמין
- מים חמין דהא אין משתנין מברייתם
ע"י האור: וקליות - נמי לא נשתנו:
שיעתא ביזרא דכרפסא - זרע של
כרפס: שבלילתא - פנגריי"א והוא
תלתן: ותרו להו - שורין אותן במים:
דמקבל - שצומחין: גרגישתא -
ארזיל"א: ומדבקין - הנך ביזרא:
מבינתא דרישייהו - שיער ראשו וקמ"ל
ברייתא דאי נמי תרו להו בחמימי
שרי: במילין - על ידי דברי לחש של כשפים הן
עושין: הכוספן
- פסולת של תמרים שעשו מהן שכר
וחולטין אותן: ודלמא אדמויי אדמוה -
נתחוה לאברים והכניסוה ונתבשלה בו
ועכשיו פלט הטעם בחמין הללו:
אלא כל שאין ראש צפור דרור כו' - ואין לך
חתיכת איסור
קטנה מזו: איערובי
- שמא נתערב בו יין:
סרי - מסריח: חוליי לא תיבעי לך - מתוקים ודאי שרו דאי
משום בישולי עובדי כוכבים הרי נאכלין חיין: מרירין - אינן
נאכלין ובישולן ממתקן: מציעאי - נאכלין חיין ע"י הדחק: בחיטי
או שערי - אין דרך לתת שם חומץ: טלופחי - עדשים: ואית
דאמרי בטלופחי
ומיא כ"ע לא פליגי דאסור - דמיחלף בטלופחי וחלא:
וספות - כלים להשתמש כמו שומרי הסף
: תרי זימני כתיב קלי בקרא והיינו תרי מיני
שתיתא: ומאי שנא ממורייס
- דרובא דעלמא שדו ביה חמרא והוי בידוע: מגיסה
- מהפכת בכף:
