נו'יי 'ני)' יבח: יוי'י יוב יני' בבח ב ננו י''יו י'י'ינו וחיני י'ו יו ינו יייי יניי) ניח נחיח'י) י'יוייי ייח 'י: 'יב יינבו יינ'י: ני'יחייכי נייני:. נויד'
ונ' בי ביבב םביבהיו בי ב'וי) וםבי נו'יני: ייב' ב: 'םי'י' ני 'נ'י ובבו נונ ובי בבי וחיבי ביי אח' יבי' חביב. נני: חוייו ו'ו בדי: נהבי'י: ': א חב'ד
נניני: יהי ום הויה ינד םוא והיו נננייד אהיי זינו נבדי נ' 'יינם החיו ח: הניני: ננובח:י יאח חננ חנ יני יח'י דדי. חהמני ביני יזיבי נננ נה דהיי) )נבי
נונייי יד'יי) )נחי בדיי) י'ני'י ''נ בייני: אי נבנו 'יי): ב'יח ובני חביינ חי'ו 'בי' ח: חנוני: ינ' ננביי בחי וה ב: יחב: םיו חיני: וב'י דחא
..,,.., נ.ניניייח.נוינו'ייחוחי)ייי'יי)הובי
ננניח ניח אנא איחני ננו. נד)יו: נוודן
ניינ חני חבא הי זוחיננ וננה נ'כ הניח
חנניי: איח) חחוי יחד' אמה םי: חננר:
איחה חדנו אח' '' אייא אד' 'י יו'נ: ני'ב )א
וחדוה הם ונשים ואח' וי םכי אחד ני
יי'י: נ)'וה אהיוי חיד יחו' אי: חכנוי: חו)
זיויז דזיכ 'היו: זחם יחנויני ו'זיח יוי ויזי
החנאנה. ונ)ים נא'ד וינח' ניי: כניח ונד
חדייד אי: חבנר: חח: 'נ' זביי חחריד
דבנוי: ח)ו כיר נכי ננ' )בח'ד אח' 'נ
ייחד ני: יי אחח נרם בינ חיי ננ נ'
ויוםה וחבנז ב: חננוי: דו: יהי םום יחיו
הכ 'ונ יינוי: נניח נבחינ יננכ םי: 'וכ
יינהי: ניויזר)י אני חייניפ ננונו: וייפ
ייזדאויח אנו נחניח נא וושיכו: ח'י חחנב ח'י
חחח: חמיר. הי'ינ ז): ווח: וביי: אד '''יכ
נני: וי יויו: וד ודיי: אוי'ז ננםו כיו
אוכ ככהיינ נבונו: נהחי. חנ ידי ימו יני
חנידי חיינ נבנני: אבב. ונ בוחי ינם נחו
וי): 'וי ונו חנידוי ד'ח אוחר נ' ביונוי:.
י'יזוחי אויה באי: זכני חי'ו בוניי חי'ה
נויח' הווי'י הוה ו)חיינ יי): הזני דנ 'ני'ו
)יאיו זויח: י): נכ ובוני: ונ' יו'י) ז'ייח.
נוי): זבוי םוכ והכיו ד: כבוני: ויי אכ
יח: םבו ווה יום ח: חי') ביני: וחיבה)
םזיי כמ המיד נכונו:: םח' 'ני חםי'
בחי: דדנו 'ו ויוי' ובביו נ'יר כי'
חח'( נו' ונניב יו'םוי יחםו י'חר
זה יחיי ניכ יחניי נח: חומ וימיו ששנ חיינ
נ' ביונניח. י'יזוחי אח' ר אנוי' ו'י
דב' נאח' '''' זבו זוי) ייח: י''נ הבי
נהיא ייכי 'נ םח' ו'י) ויא. םדב זבו ווים
ייחי יא'ו יונ' חי'). ווי): )נב היי ניוי
יני: חנידי היבו וחנידי יוו) ני חרנ ני
ביינייח ויא נ): בוו הבבו מי דבינ ובנ
ח: ההבוו: נניני חיי חני מיי שווי. חםוי
נייח: וי חשוו המי' כביוני: 'וה''י זוא ר'וו
מו'יא זני'כי' ככ זנוי ינכ: כנכ זוכ: אנו
אפ וויי: ני חיינ. נהיי בבוי הים נח: יויי
יח'ינ נד ויא נביוני: והניוח וו. יו)ייב והדנ
וכיו כנ 'יח םומיה ואח'י ווינ וו יבי יוייי
'ד'ו םיינ נביוני: םםב החכ נח: וי חשיו
נו ונם זחוחי דינ ' וחי: חיחחש וחייניו
נביוני: חחירי: חחחחד נבבו. םה 'ובו חחי:
'ניהכ םוייה וםי'י ייזחחוי 'ייה: נו א'ב
יםהונכיוני:םככ'ייזכיכאניו:זיכנוויבן ..............................................
יככי' ח: הבייני: םד )יי במייכ המייו בחו: וביו בו יו כבמ: וכי' יאה ויי נבייו 'י' ימ'י: יינם י'ח' נבייו ו'ו ויחו'י בני'י ויח: ביי) בי יוחב