דמסרג - שיש לו אוכף על גביו יפה: נס נעשה לו - נו"ן כנגד
נו"ן וכגון שראה השם כתוב: חנינא - נוני"ן הרבה נסים רבים:
והני מילי בכתבא - אכולהו קאי שראה הונא או חנינא או תיבה
זו של הספד כתובה דמשמע חסו עליו ופדאוהו: דלא סיים
- שנעור משנתו קודם שנסתלק סימן
הוא שסמוך אצל הקב"ה: מובטח
לו שהוא בן העולם הבא
- ונוטל חלקו
וחלק חברו בגן עדן
דדמי לאשת איש: פלגי - רמונים שנחלקו: יצפה לתורה
- שנאמר אשקך מיין הרקח היינו תורה:
מעסיס רמוני - הנמצץ מן הרמונים: נכסיו מצליחין - כהדס זה שעליו
משולשים זה על זה כמין קליעה: בכנייהו - על
כנם במקומם במחובר: הוי ראש ישיבה
- שמכריז ומצוה לרבים: אני ראיתיה
וכו' - ועל כן נעשיתי ראש ישיבה
במתא מחסיא: תרביצא - גינה א"נ
בהמ"ד תרביצא נאה וגילה נוטריקון
של תרנגול: תלויה בקשתו - בספק
כביצים הללו שהאוכל סתום בם:
נשתברו - נתגלה האוכל: וינחם אל
מחוז - היינו כרך: חפצם - סימן
הוא להיות חפציו נעשים: המגלח
- סימן גדולה ותפארת היא לו כמו
ויגלח ויחלף וגו' : בעריבה - בספינה:
דמדלי
- שהולכת בגובה של ים: הנפנה
- סימן הוא שסרחונו וגנותו נפרש
ויוצא מעליו: והוא דלא קנח
- שלא המאיס ידיו: בבבל עומד
