גזיזי דברדא - חתיכות של ברד והקרח שקורין גלאנצ"א בלע"ז והיינו ביום השלג: ונחת וטבל לקריו - כדי לעסוק בתורה: דתנא
סיפרא דבי רב - תורת כהנים: חלל רשע - על צדקיהו הוא אומר ועדיין בימי יחזקאל חי היה וקורהו חלל: לקריתא - להתעסק
בעבודת אחוזתם: אייקר תלמודייהו - אשתכח תלמודם מגרסתם. אייקר הוכבד עליהם מחמת שכחה: צערא דידהו - צער גופם ממש
כגון עקיצת הרימה: שתי רוחות - של שתי ילדות מתות: ונשמע - ונדע מה גזרו היום פורענות בעולם. שהעולם נדון בר"ה:
הפרגוד - מחיצה המבדלת בין מקום השכינה:
ברביעה ראשונה - יורה. שלש
רביעיות הן בכירה שניה ושלישית
ראשונה בי"ז במרחשון שניה בכ"ג
שלישית בר"ח כסליו: ברד מלקה
אותו - שעתיד ברד ליפול סמוך
לרביעה ראשונה ומה שנזרע כבר
הוקשה והברד שוברו והנזרע בשניה
עדיין רך הוא ואינו נשבר בשביל
הברד כענין שנאמר והפשתה
והשעורה נכתה והחטה והכוסמת
לא נכו : שדפון - מלקה
הרך ואינו משדף הקשה: אלמא
ידעי - דברים האמורים בין החיים:
לחצר מות - לבית הקברות: בצנורא
דדשא - בחור מפתן הבית שהדלת
סובב אותו: מסרקאי - מסרק שלי:
גובתא - קנה ובשביל שמתה ילדה
אמרה כן לעגמת נפש: בהדי
פלניתא דאתיא למחר - לקבורה:
אלמא ידעי - מה שעושין שידעה זו
שזו גוססת ונטויה למות: דלמא
דומה - מלאך שהוא ממונה על
המתים קדים ומכריז להו עכשיו
יבא פלוני אבל שאר דברי החיים
אינם יודעים: בעינא אבא - מבקש
אני את אבא כך היה שמו: א"ל
- המתים נגלו לו כאילו הם חוץ
מקבריהם ויושבים בעגולה: חזייה
- שמואל ללוי חברו שהיה יושב חוץ
לישיבה של שאר מתים: כל כי הנך
שני - מספר השנים שלא נכנסת
בישיבתו של רבי אפס במס' כתובות
בפרק הנושא את האשה (דף קג:):
חזייה - שמואל לאבוה דקא בכי וחייך:
דלעגל אתית - במהרה תקבר:
באמתא דרחיא - כל בנין מושב
הרחים קרוי אמת הרחיים: אלמא
ידעי - מי חשוב בין החיים:
זאת הארץ - במיתת משה כתיב:
