עלה ראש הפסגה - בדבר תפלה זו נתרציתי להראותך אותה:
ובפרשכם כפיכם - אי לאו דגדולה תפלה כיון דאמר למה לי רוב
זבחיכם למה לי תו ובפרשכם הא אפילו זבחיהם לא ניחא ליה: אל
תחרש - מדלא כתיב את דמעתי תראה ש"מ נראית היא לפניו ואין
צריך להתפלל אלא שתתקבל לפניו:
ונתתה אותה קיר ברזל - סימן למחיצת
ברזל המפסקת בינו לבינם: ומעיין
בה - מצפה שתעשה בקשתו על ידי
הארכתו סוף שאינה נעשית ונמצאת
תוחלת ממושכה חנם והיא כאב לב
כשאדם מצפה ואין תאותו באה:
תוחלת - לשון חלוי ותחנה: ועץ חיים
תאוה באה - סופו של מקרא הוא:
קוה - והתחזק ולא תמשוך ידך אלא
חזור וקוה: צריכין חזוק - שיתחזק
אדם בהן תמיד בכל כחו: דרך ארץ
- אם אומן הוא לאומנתו אם סוחר
הוא לסחורתו אם איש מלחמה הוא
למלחמתו: שלשים חיל - ראשי גייסות
וחבורות חלוקות: לגיון וקרטון
וגסטרא - שמות של שררה כגון שלטון
והגמון ודוכס ופחה: עולה - כמו עולות
וקרבנות: גם אלה - מעשה העגל
שאמרו אלה אלהיך ישראל :
ואנכי זה מעשה סיני - שנאמר בו
אנכי ה' אלהיך : יושבי
ביתך - והדר יהללוך: יודו לשמך
- והדר ישבו ישרים את פניך: תשע
שעות - לשלש תפלות: תורתם
משתמרת - בתוך לבם שאין
תלמודם משתכח: אבל
למלכי עכו"ם
