דשיילינן להו - אם ראו הפרעון ואם לאו נאמן המלוה לומר שלא נכתב אלא להיות מוכן לכשיפרע: יתקיים
בחותמיו - ואפי' יוצא
מתחת יד מלוה כשר: ויוצא מתחת ידי שליש - שאין הלוה מוציאו ולא המלוה
אלא שליש שביניהם נאמן: או שיצא אחר
חיתום שטרות
- שיצא לפנינו כשהוא כתוב בשטר
חוב אחר החתימה
כשר: דהא הימניה מלוה
לשליש - דעל כרחך אין כותב שובר אלא מלוה והוא
מסרו ליד השליש: מתני'
אלו מציאות: מצא פירות מפוזרין - נתייאשו הבעלים מהן
כדאמר בגמרא והפקר הן: מעות מפוזרות -
הואיל
ואין להם סימן ניכר איאושי מיאש והוו להו הפקר וזהו
טעם כולם: כריכות - עומרים קטנים כמו מאלמים אלומים
ומתרגמינן בירושל' מכרכן כריכן : של נחתום -
כל ככרות הנחתומין שוין אבל ככרות של
בעל הבית יש בהן
סימן: ממדינתן - כמות שהן גזוזות כשאר כל גיזת המדינה
לאפוקי הבאות מבית האומן כדקתני סיפא:
אניצי פשתן - רישט"א בל' אשכנז ובמקומינו
פופי"ר: מצא עיגול - של דבילה: אנפוריא
- בגמ' מפרש: גמ' וכמה - חשוב
פיזור: אי דרך נפילה - אם מצאם
דרך נפילה שיש לדעת שלא הונחו שם מדעת אלא
נפלו: אפילו טובא - מקב נמי דכיון דאין בהן
סימן איאושי מיאש: ואי דרך
הינוח וכו' - עתיד לחזור וליטלן: במכנשתא דבי דרי
- בשעת אסיפת גרנות וכאן דשן בעליהן ונשאו את העיקר
ונותרו אלו: בציר מהכי
- אם היה פזורן בפחות מכן: תמרים ורמונין -
גסים הן ואין טורח בקבוצן:
